[console_scripts]
autoassist = toolmateai.autoassist:main
autobuilder = toolmateai.autobuilder:main
autoretriever = toolmateai.autoretriever:main
chatgpt = toolmateai.chatgpt:main
chatserver = toolmateai.servers:chat
codellama = toolmateai.ollamachat:codellama
codey = toolmateai.codey:main
commandprompt = toolmateai.commandprompt:main
customchatserver = toolmateai.servers:customchat
customtoolserver = toolmateai.servers:custommain
customvisionserver = toolmateai.servers:customvision
etextedit = toolmateai.eTextEdit:main
geminipro = toolmateai.geminipro:main
geminiprovision = toolmateai.geminiprovision:main
gemma2b = toolmateai.ollamachat:gemma2b
gemma7b = toolmateai.ollamachat:gemma7b
groqchat = toolmateai.groqchat:main
letmedoit = toolmateai.main:letmedoit
llama3 = toolmateai.ollamachat:llama3
llama370b = toolmateai.ollamachat:llama370b
llamacpp = toolmateai.llamacpp:main
llamacppserver = toolmateai.llamacppserver:main
llava = toolmateai.ollamachat:llava
mistral = toolmateai.ollamachat:mistral
mixtral = toolmateai.ollamachat:mixtral
ollamachat = toolmateai.ollamachat:main
orca2 = toolmateai.ollamachat:orca2
palm2 = toolmateai.palm2:main
phi3 = toolmateai.ollamachat:phi3
rag = toolmateai.rag:main
starlinglm = toolmateai.ollamachat:starlinglm
toolmateai = toolmateai.main:main
toolmateaihub = toolmateai.systemtray:main
toolserver = toolmateai.servers:main
vicuna = toolmateai.ollamachat:vicuna
visionserver = toolmateai.servers:vision
wizardlm2 = toolmateai.ollamachat:wizardlm2

