[console_scripts]
autoassist = freegenius.autoassist:main
autobuilder = freegenius.autobuilder:main
autoretriever = freegenius.autoretriever:main
chatgpt = freegenius.chatgpt:main
chatserver = freegenius.servers:chat
codellama = freegenius.ollamachat:codellama
codey = freegenius.codey:main
commandprompt = freegenius.commandprompt:main
customchatserver = freegenius.servers:customchat
customtoolserver = freegenius.servers:custommain
customvisionserver = freegenius.servers:customvision
etextedit = freegenius.eTextEdit:main
freegenius = freegenius.main:main
freegeniushub = freegenius.systemtray:main
geminipro = freegenius.geminipro:main
geminiprovision = freegenius.geminiprovision:main
gemma2b = freegenius.ollamachat:gemma2b
gemma7b = freegenius.ollamachat:gemma7b
groqchat = freegenius.groqchat:main
letmedoit = freegenius.main:letmedoit
llama3 = freegenius.ollamachat:llama3
llama370b = freegenius.ollamachat:llama370b
llamacpp = freegenius.llamacpp:main
llamacppserver = freegenius.llamacppserver:main
llava = freegenius.ollamachat:llava
mistral = freegenius.ollamachat:mistral
mixtral = freegenius.ollamachat:mixtral
ollamachat = freegenius.ollamachat:main
orca2 = freegenius.ollamachat:orca2
palm2 = freegenius.palm2:main
phi3 = freegenius.ollamachat:phi3
rag = freegenius.rag:main
starlinglm = freegenius.ollamachat:starlinglm
toolserver = freegenius.servers:main
vicuna = freegenius.ollamachat:vicuna
visionserver = freegenius.servers:vision
wizardlm2 = freegenius.ollamachat:wizardlm2

